* * * * * * * * * * * * * * * * *
*                               * 
*   * * * * *   *   * * *   *   * 
*           *   *       *   *   * 
*   * * *   * * *   *   * * *   * 
*       *       *   *       *   * 
*   * * *   * * *   *   * * * * * 
*       *       *   *           * 
*   *   * * * * *   * * *   * * * 
*   *           *       *       * 
*   *   *   * * * * * * *   * * * 
*   *   *               *       * 
*   *   * * *   * * *   *   * * * 
*   *       *       *   *       * 
*   *   * * *   *   *   * * *   * 
*   *       *   *   *       *   * 
* * * * * * * * * * * * * * * * * 

